############################################################
#                            #                             #
#                            #                             #
#                            #                             #
#     ###########            #                             #
#  @  #         #            #                             #
#     #         #            #                             #
#     #         #            #                             #
#     #         #            #                             #
#     #         #            #                             #
#     ###########            #                             #
#                                                          #
#                                                          #
#                                                          #
#                            #            ##########       #
#                            #            #        #       #
#                            #            #        #       #
#                            #            #        #       #
#                            #            #        #   @   #
#                            #            ##########       #
#                            #                             #
#                            #                             #
#                            #                             #
#                            #                             #
############################################################
